R 800 600

NO textures/wall_1.xpm
SO textures/wall_2.xpm
WE textures/wall_3.xpm
EA textures/wall_4.xpm
S textures/pillar.xpm

F 51,46,96
C 239,238,143

111111111111111111111
100000000000022222001
100000000000000000001
100000000000000000001
100000000000000000001
100000000000000000001
100000000000000000001
100000000000000000001
100000001111100000001
1000000011 1100000001
100000001111100000001
100000002222200000001
100000000000000000001
100111100000000000001
100100100000001111001
1001000000N0001001001
100100100000002001001
100111100000001111001
100000000000000000001
111111111111111111111
